fxxxxxxxxxxxxxxxxxxxy
yo-----------------oy
y--r--r--r--r--r--r-y
y-------------------y
y------------o------y
y-r--r--r--r--r--r--y
y-------------------y
y--------o----------y
y--r--r--r--r--r--r-y
y-------------------y
y--------------o----y
y-r--r--r--r--r--r--y
y-------------------y
yP------------------y
xxxxxxxxxxxxxxxxxxxxx